XXXXXXXXXXXXXXXXXXXXXXXXX
X                       X
XXXXXXXXXXX XXXXXXXXXXX X
X     X     X         X X
X XXX X XXXXX XXXXXXXXX X
X   X X     X           X
XXX X XXXXX X XXXXXXXXX X
S X X       X         X X
X X XXXXXXXXX XXXXXXX X X
X X X         X       X X
X X XXXXXXXXXXX XXXXXXX X
X   X           X     XXX
XXXXX XXXXXXXXXXX XXX   X
X     X           XXXXX X
X XXXXX XXXXXXXXXXXXXXX X
X XXXXX XXXXXXXXXXXXXXX X
X       X               E
XXXXXXXXXXXXXXXXXXXXXXXXX
