XXXXXXXXXXXXXXXXXXXXXXXXXXXXXXXXXXXXXXXXXX
X                             X XX       X
X XXXXXXXXXXXXXXX  XXXXXXXXX  X XXX      X
X         X                X      XXXXXXXX
X  XXXXX  XXXXXXXXXXXXXXXX XXXXXX        X
X      X                        XXXXXXXXXX
XXXXXX X  XXXXXXXXXXXXXXXXXXXXX          E
S  XXX X    X                 XXXXXXXXXXXX
X      X                                 X
XXXXXXXXXXXXXXXXXXXXXXXXXXXXXXXXXXXXXXXXXX
